; Citadel Defense 3D level format v1
id=tutorial
name=Straznica
size=12,12
grid=begin
############
#..........#
#..BBB.....#
#S.RRRRRR..#
#..B....R..#
#..B....R..#
#..BBB..R..#
#.......R..#
#...BBBBR..#
#.......E..#
#..........#
############
path=1,3;2,3;3,3;4,3;5,3;6,3;7,3;8,3;8,4;8,5;8,6;8,7;8,8;8,9
